<?xml version="1.0" encoding="utf-8" ?> 
<map>
    <info>
        <name>Дорога</name>
        <desc>Первая карта с дорогой, большим озером и городом.</desc>
        <version>1.0</version>
        <size width="25" height="25" />
        <schema>summer</schema>
    </info>
    
    <landscape>
        ooooooo...++.************
        +++++++++++..******..****
        ooooooo..+..**..*********
        ooooooo..+..***.*********
        ........++.****.....**~~*
        **..**..+..*....:::...~..
        *~~~**.++....:::::::.....
        **~~**.+:..:::~~~~~~.....
        ******.+:..:~~~~~~~~~~...
        ******.+...~~~~~~~~~~~:..
        ******.+..o~~~~~~~~~~~:..
        .......+..o~~~~~~~~~~~~..
        ++++++++..oo~~~~~~~~~~~oo
        .......+..oo~~~~~~~~~~~oo
        ******.++..o~~~~~~~~.~~~o
        ........+..o~~~~~~~~.~~~o
        ~~~~~...+....~~~~~~~~~~oo
        ~~~~~...+....~~:::~~~~~oo
        ~~~~....+.....::::::::...
        ~~~..**.+.***............
        ....***.+.*************..
        *******.+.***************
        *******.+.***************
        *******.+.***************
        *******.+.*****~~~*******
    </landscape>
    
    <impassability>
        0000000000000000000000000
        0000000000000000000000000
        0000000000000000000000000
        0000000000000000000000000
        0000000000000000000000000
        1000000000000000000000000
        1000000000000000000000000
        1000000000000000000000000
        1111100000000000000000000
        1111100000000000000000000
        0000000000000000000000000
        0000000000000000000000000
        0000000000000000000000000
        0000000000000000000000000
        0000000000000000000000000
        0000000000000000000000000
        0000000000000000000000000
        0000000000000000000000000
        0000000000000000000000000
        0000000000000000000000000
        0000000000000000000000000
        0000000000000000000000000
        1111100000000111111111000
        1111111000000001111111111
        1111111000001110000001111
    </impassability>
</map>