<?xml version="1.0" encoding="utf-8" ?> 
<map>
    <info>
        <name>Тесты</name>
        <desc>Тестирование всякого.</desc>
        <version>1.0</version>
        <size width="25" height="25" />
        <schema>summer</schema>
    </info>
    
    <landscape>
        .........................
        .........................
        .........................
        .........................
        .........................
        .........................
        ~~~~.....................
        ...~~~~..................
        ......~~~~.H.............
        **.......~~H~~~..........
        ***........H..~~~........
        *****...........~~~......
        *****.............~~~~...
        *****................~~~~
        ***.....................~
        **.......................
        .........................
        .........................
        .........................
        .........................
        .........................
        .........................
        .........................
        .........................
        .........................
    </landscape>
    
    <impassability>
        0000000000000000000000000
        0000000000000000000000000
        0000000000000000000000000
        0000000000000000000000000
        0000000000000000000000000
        0000000000000000000000000
        0000000000000000000000000
        0000000000000000000000000
        0000000000000000000000000
        0000000000000000000000000
        0000000000000000000000000
        0000000000000000000000000
        0000000000000000000000000
        0000000000000000000000000
        0000000000000000000000000
        0000000000000000000000000
        0000000000000000000000000
        0000000000000000000000000
        0000000000000000000000000
        0000000000000000000000000
        0000000000000000000000000
        0000000000000000000000000
        0000000000000000000000000
        0000000000000000000000000
        0000000000000000000000000
    </impassability>
    
    <cells>
        <cell id='A' name="Болото" passable="false" passcost="10" color="#ff0000" image="" />
    </cells>
</map>