<?xml version="1.0" encoding="utf-8"?>
<map xmlns:xsi="http://www.w3.org/2001/XMLSchema-instance" xmlns:xsd="http://www.w3.org/2001/XMLSchema">
    <info>
        <name>Мост</name>
        <desc>Мост через Днепр</desc>
        <version>1.0</version>
        <size width="25" height="25" />
        <schema>summer</schema>
    </info>
    <landscape>
        *******..~~~~~~~~~~~..***
        *****....~~~~..~~~~~...**
        .........~~~~...~~~~.....
        #########ЖЖЖЖЖЖЖЖЖЖЖ#####
        .........~~~~...~~~~.....
        +++++++++HHHHHHHHHHH+++++
        .........~~~~~..~~~~.....
        .....*....~~~~..~~~...***
        .....*....~~~~~~~~~..****
        .....*....~~~~~~~~:..****
        .....*....~~~~~~~~:...***
        .....*....:~~~~~~~::..***
        .....*....:~~~~~~~~:...**
        ...***~...:~~~~~~~~::..**
        ...***~...::~~~~~~~~:..**
        ...****....:~~~~~~~~:..**
        ..*****....:~~~~~~~~:..**
        ..******.....~~~~~~~~...*
        .*******.....~~~~~~~~...*
        .*******.....~~~~~~~~o.**
        .********....o~~~~~~~o.**
        .********....oo~~~~~~o.**
        .********.....o~~~~~~o.**
        .********.....o~~~~~~o..*
        .*********....o~~~~~~o..*
    </landscape>
    <impassability>
        0000000001000000000100000
        0000000001000000000100000
        0000000001000000000100000
        0000000000000000000000000
        0000000001000000000100000
        0000000000000000000000000
        0000000001000000000100000
        0000000000100000001000000
        0000000000100000001000000
        0000000000100000000000000
        0000000000100000000000000
        0000000000000000000000000
        0000000000000000000000000
        0000000000000000000000000
        0000000000000000000000000
        0000000000000000000000000
        0000000000000000000000000
        0000000000000100000010000
        0000000000000100000010000
        0000000000000100000010000
        0000000000000010000010000
        0000000000000001000010000
        0000000000000001000010000
        0000000000000001000010000
        0000000000000001000010000
    </impassability>
</map>