<?xml version="1.0" encoding="utf-8" ?> 
<map>
    <info>
        <name>Вода</name>
        <desc>Тестирование всякого.</desc>
        <version>1.0</version>
        <size width="25" height="25" />
        <schema>0</schema>
    </info>
    
    <landscape>
        0000000000003333333333333
        0000000000333333333333333
        0033333333333333333333333
        0333333333333333333333333
        3333333333333333333333333
        3333333333333333333333333
        3333333333333333333333333
        3333333333333333333333333
        3333333333333333333333333
        3333333333333333333333333
        3333333333333333333333333
        3333333333333333333333333
        3333333333333333333003333
        3333333333333333330003333
        3333333333333333300033333
        3333333333333330000033333
        3333333333333330000033333
        3333333333333300000333333
        3333333333333000033333333
        3333333333333330033333333
        3333333333333333333333333
        0003333333333333333333333
        0003333333333333333333333
        0000033333333333333333333
        0000000333333333333333333
    </landscape>
    
    <impassability>
        0000000000000000000000000
        0000000000000000000000000
        0000000000000000000000000
        0000000000000000000000000
        0000000000000000000000000
        0000000000000000000000000
        0000000000000000000000000
        0000000000000000000000000
        0000000000000000000000000
        0000000000000000000000000
        0000000000000000000000000
        1111111100000000000000000
        0000000000000000000000000
        0000000000000000000000000
        0000000000000000000000000
        0000000000000000000000000
        0000000000000000000000000
        0000000000000000000000000
        0000000000000000000000000
        0000000000000000000000000
        0000000000000000000000000
        0000000000000000000000000
        0000000000000000000000000
        0000000000000000000000000
        0000000000000000000000000
    </impassability>
</map>