<?xml version="1.0" encoding="utf-8" ?> 
<map>
    <info>
        <name>Вода</name>
        <desc>Тестирование всякого.</desc>
        <version>1.0</version>
        <size width="25" height="25" />
        <schema>summer</schema>
    </info>
    
    <landscape>
        --------------~~~~~~~~~~~
        ----------~~+~~~~~~~~~~~~
        --~~~~~~~~~~~~~~~~~~~~~~~
        -~~~~~~~~~~~~~~~~~~~~~~~~
        ~~~~~~~~~~~~~~~~~~~~~~~~~
        ~~~~~~~~~~~~~~~~~~~~~~~~~
        ~~~~~~~~~~~~~~~~~~~~~~~~~
        ~~~~~~~~~~~~~~~~~~~~~~~~~
        ~~~~~~~~~~~~~~~~~~~~~~~~~
        ~~~~~~~~~~~~~~~~~~~~~~~~~
        ~~~~~~~~~~~~~~~~~~~~~~~~~
        ~~~~~~~~~~~~~~~~~~~~~~~~~
        ~~~~~~~~~~~~~~~~~~~--~~~~
        ~~~~~~~~~~~~~~~~~~---~~~~
        ~~~~~~~~~~~~~~~~~---~~~~~
        ~~~~~~~~~~~~~~~-----~~~~~
        ~~~~~~~~~~~~~~~-----~~~~~
        ~~~~~~~~~~~~~~-----~~~~~~
        ~~~~~~~~~~~~~----~~~~~~~~
        ~~~~~~~~~~~~~~~--~~~~~~~~
        ~~~~~~~~~~~~~~~~~~~~~~~~~
        ---~~~~~~~~~~~~~~~~~~~~~~
        ---~~~~~~~~~~~~~~~~~~~~~~
        -----~~~+~~~~~~~~~~~~~~~~
        ----------~~~~~~~~~~~~~~~
    </landscape>
    
    <impassability>
        0000000000000000000000000
        0000000000000000000000000
        0000000000000000000000000
        0000000000000000000000000
        0000000000000000000000000
        0000000000000000000000000
        0000000000000000000000000
        0000000000000000000000000
        0000000000000000000000000
        0000000000000000000000000
        0000000000000000000000000
        1111111100000000000000000
        0000000000000000000000000
        0000000000000000000000000
        0000000000000000000000000
        0000000000000000000000000
        0000000000000000000000000
        0000000000000000000000000
        0000000000000000000000000
        0000000000000000000000000
        0000000000000000000000000
        0000000000000000000000000
        0000000000000000000000000
        0000000000000000000000000
        0000000000000000000000000
    </impassability>
</map>