<?xml version="1.0" encoding="utf-8" ?> 
<map>
    <info>
        <name>Дорога</name>
        <desc>Первая карта с дорогой, большим озером и городом.</desc>
        <version>1.0</version>
        <size width="25" height="25" />
        <schema>0</schema>
    </info>
    
    <landscape>
        7777777000660555555555555
        6666666666600555555005555
        7777777006005500555555555
        7777777006005550555555555
        0000000066055550000055335
        5500550060050000222000300
        5333550660000222222200000
        5533550620022233333300000
        5555550620023333333333000
        5555550600033333333333200
        5555550600433333333333200
        0000000600433333333333300
        6666666600443333333333344
        0000000600443333333333344
        5555550660043333333303334
        0000000060043333333303334
        3333300060000333333333344
        3333300060000332223333344
        3333000060000022222222000
        3330055060555000000000000
        0000555060555555555555500
        5555555060555555555555555
        5555555060555555555555555
        5555555060555555555555555
        5555555060555553335555555
    </landscape>
    
    <impassability>
        0000000000000000000000000
        0000000000000000000000000
        0000000000000000000000000
        0000000000000000000000000
        0000000000000000000000000
        1000000000000000000000000
        1000000000000000000000000
        1000000000000000000000000
        1111100000000000000000000
        1111100000000000000000000
        0000000000000000000000000
        0000000000000000000000000
        0000000000000000000000000
        0000000000000000000000000
        0000000000000000000000000
        0000000000000000000000000
        0000000000000000000000000
        0000000000000000000000000
        0000000000000000000000000
        0000000000000000000000000
        0000000000000000000000000
        0000000000000000000000000
        1111100000000111111111000
        1111111000000001111111111
        1111111000001110000001111
    </impassability>
    
    <cells>
        <cell id='A' name="Болото" passable="false" passcost="10" color="#00ff00" image="" />
    </cells>
</map>